Pepper => Serpent Staff
Birth Seal => Pochette Key
Life Seal => bunplus.com
Chakram => Magatama Jewel
Ankh Jewel (Gate of Guidance) => Death Seal
Grapple Claw => Earth Spear
Cog of the Soul => miracle.exe
Serpent Staff => Sacred Orb (Shrine of the Mother)
Dimensional Key => Rolling Shuriken
Isis' Pendant => Plane Model
Rolling Shuriken => Helmet
Sacred Orb (Temple of the Sun) => Hand Scanner
Plane Model => Pistol
Gauntlet => Dimensional Key
Glove => Vessel
Treasures => Ice Cape
Map (Temple of Moonlight) => reader.exe
Crucifix => move.exe
Sacred Orb (Twin Labyrinths) => Spaulder
emusic.exe => Scalesphere
Sacred Orb (Shrine of the Mother) => capstar.exe
Sacred Orb (Tower of Ruin) => Knife
Sacred Orb (Chamber of Extinction) => Diary
yagostr.exe => Crystal Skull
Map (Gate of Illusion) => Philosopher's Ocarina
Bronze Mirror => Heatproof Case
Map (Dimensional Corridor) => Fake Silver Shield
Mulana Talisman => Map (Endless Corridor)
Origin Seal => Birth Seal
Sacred Orb (Surface) => Key of Eternity
mirai.exe => beolamu.exe
Diary => Isis' Pendant
Sacred Orb (Gate of Guidance) => Bracelet
Map (Chamber of Extinction) => Ankh Jewel (Twin Labyrinths)
Feather => Shell Horn
mekuri.exe => Hermes' Boots
Map (Gate of Guidance) => Ankh Jewel (Gate of Guidance)
Djed Pillar => Flail Whip
Map (Twin Labyrinths) => emusic.exe
lamulana.exe => Map (Twin Labyrinths)
Sacred Orb (Spring in the Sky) => Bronze Mirror
Shell Horn => Angel Shield
Ring => Map (Tower of the Goddess)
Map (Graveyard of the Giants) => yagomap.exe
Ankh Jewel (Twin Labyrinths) => Talisman
Sacred Orb (Dimensional Corridor) => Scriptures
Map (Chamber of Birth) => Chain Whip
Map (Endless Corridor) => mekuri.exe
Caltrops => Glove
Maternity Statue => Caltrops
mantra.exe => Cog of the Soul
Chain Whip => Map (Shrine of the Mother)
Scalesphere => Pepper
bunplus.com => Sacred Orb (Temple of the Sun)
Ankh Jewel (Dimensional Corridor) => Ring
Angel Shield => Fairy Clothes
Map (Tower of the Goddess) => Woman Statue
Map (Temple of the Sun) => Map (Spring in the Sky)
bounce.exe => lamulana.exe
Mini Doll => Mulana Talisman
Silver Shield => Book of the Dead
Ankh Jewel (Temple of the Sun) => Holy Grail
Earth Spear => bunemon.exe
Eye of Truth => Gauntlet
Key Sword => Map (Mausoleum of the Giants)
Fruit of Eden => Mini Doll
Map (Surface) => Sacred Orb (Twin Labyrinths)
Shuriken => Origin Seal
Flare Gun => Feather
Talisman => Fruit of Eden
Magatama Jewel => Treasures
Key of Eternity => Chakram
Fairy Clothes => Sacred Orb (Chamber of Extinction)
Ankh Jewel (Spring in the Sky) => bounce.exe
deathv.exe => deathv.exe
Map (Tower of Ruin) => Sacred Orb (Spring in the Sky)
Map (Inferno Cavern) => Ankh Jewel (Mausoleum of the Giants)
Book of the Dead => Shuriken
Vessel => Map (Surface)
Knife => torude.exe
Pochette Key => Map (Temple of the Sun)
Ankh Jewel (Mausoleum of the Giants) => Ankh Jewel (Spring in the Sky)
Bomb => Flare Gun
Katana => Crucifix
Map (Spring in the Sky) => Sacred Orb (Tower of Ruin)
Death Seal => Buckler
Crystal Skull => Map (Chamber of Extinction)
Map (Shrine of the Mother) => Key Sword
Perfume => Maternity Statue
Twin Statue => Map (Temple of Moonlight)
Ankh Jewel (Tower of Ruin) => yagostr.exe
Axe => Lamp of Time
Philosopher's Ocarina => Katana
Map (Mausoleum of the Giants) => Eye of Truth
Holy Grail => Twin Statue
Flail Whip => mantra.exe
Anchor => Silver Shield
Spaulder => Map (Chamber of Birth)
Ice Cape => Ankh Jewel (Temple of the Sun)
Woman Statue => Map (Gate of Guidance)
beolamu.exe => Ankh Jewel (Chamber of Birth)
Sacred Orb (Mausoleum of the Giants) => Grapple Claw
