Birth Seal => lamulana.exe
Life Seal => Ankh Jewel (Twin Labyrinths)
Ankh Jewel (Gate of Guidance) => Ankh Jewel (Temple of the Sun)
Grapple Claw => Ice Cape
Cog of the Soul => Pochette Key
Serpent Staff => Map (Shrine of the Mother)
Dimensional Key => Djed Pillar
Isis' Pendant => Dimensional Key
Gauntlet => Ankh Jewel (Dimensional Corridor)
Sacred Orb (Temple of the Sun) => Scalesphere
Glove => Death Seal
Treasures => Sacred Orb (Chamber of Extinction)
Map (Temple of Moonlight) => Ankh Jewel (Spring in the Sky)
Crucifix => Sacred Orb (Shrine of the Mother)
Sacred Orb (Twin Labyrinths) => Map (Chamber of Birth)
Sacred Orb (Shrine of the Mother) => Crucifix
Sacred Orb (Tower of Ruin) => Treasures
Sacred Orb (Chamber of Extinction) => Serpent Staff
yagostr.exe => Sacred Orb (Dimensional Corridor)
Map (Gate of Illusion) => Shell Horn
Bronze Mirror => Twin Statue
Map (Dimensional Corridor) => Map (Spring in the Sky)
Origin Seal => Sacred Orb (Mausoleum of the Giants)
Sacred Orb (Surface) => Ankh Jewel (Tower of Ruin)
mirai.exe => Map (Gate of Guidance)
Map (Chamber of Extinction) => Gauntlet
Feather => Sacred Orb (Surface)
Map (Gate of Guidance) => Origin Seal
Djed Pillar => Sacred Orb (Gate of Guidance)
Map (Twin Labyrinths) => Perfume
lamulana.exe => Map (Tower of Ruin)
Sacred Orb (Spring in the Sky) => Map (Inferno Cavern)
Sacred Orb (Gate of Guidance) => Map (Mausoleum of the Giants)
Shell Horn => Grapple Claw
Map (Graveyard of the Giants) => Sacred Orb (Tower of Ruin)
Ankh Jewel (Twin Labyrinths) => Map (Dimensional Corridor)
Sacred Orb (Dimensional Corridor) => Key of Eternity
Map (Chamber of Birth) => Map (Temple of the Sun)
Map (Endless Corridor) => Sacred Orb (Temple of the Sun)
Scalesphere => Bronze Mirror
Map (Tower of the Goddess) => bounce.exe
Ankh Jewel (Dimensional Corridor) => Life Seal
Map (Temple of the Sun) => Crystal Skull
bounce.exe => yagostr.exe
Ankh Jewel (Temple of the Sun) => Birth Seal
Key of Eternity => Sacred Orb (Spring in the Sky)
Magatama Jewel => Map (Tower of the Goddess)
Fairy Clothes => Sacred Orb (Twin Labyrinths)
Ankh Jewel (Spring in the Sky) => Cog of the Soul
Map (Tower of Ruin) => Isis' Pendant
Map (Inferno Cavern) => Map (Temple of Moonlight)
Pochette Key => Glove
Ankh Jewel (Mausoleum of the Giants) => Holy Grail
Map (Spring in the Sky) => Ankh Jewel (Mausoleum of the Giants)
Death Seal => Fairy Clothes
Crystal Skull => mirai.exe
Map (Shrine of the Mother) => Map (Endless Corridor)
Perfume => Map (Twin Labyrinths)
Twin Statue => Magatama Jewel
Ankh Jewel (Tower of Ruin) => Map (Chamber of Extinction)
Holy Grail => Feather
Map (Mausoleum of the Giants) => Map (Graveyard of the Giants)
Ice Cape => Woman Statue
Woman Statue => Map (Gate of Illusion)
Sacred Orb (Mausoleum of the Giants) => Ankh Jewel (Gate of Guidance)
